##########################################
######..     .   .## ###### ..  ##########
 ##                                  .####
                                .      ###
   .          .                         ..
.     .     .   . .   .      .  .   . .  .
.  .   ..   . . .    .  .. ... . ...... ..
... .. .  . ... .... .. .. ... ... .... ..
..... .. .   .. ..   .. ... .... . . .. ..
  . .... .....  .. .... ... . .. ..... ...
..    .     ..     .   .  .     .     .  .
.         .                         .  . .
                            .            .
                                        ..
                                       ###
..  . .#### ### #.       ..     ##     ###
###############.#####..###### ###### .####
##########################################