###################################################################################################################################
######### ######  #####   ##########    #####    ##################    ###########################################  ###### ########
############               ## #####       ##  #    ######### ###        ##########    ########### #############    ###  #  # ######
##########  #              ##   ##       #         #  ##   #  #        #####  ####       ######       ####   ###   #  #   #   #####
###  ###                  #    #  #     #  #      #   #        #       ##  #   ##       ###  #       #   ##  #  #     #         ###
### ##  #                         #                    #              #       #  #      #     #           #                    # ##
###                                                                  # #                                                        ###
##                                                                                                                               ##
##                                                                                                                               ##
##                                                                                                                              # #
#                                                                                                                                ##
#                                                                                                                                 #
                                                                                                                                  #
                                                                                                                                  .
                                                                                                                                  .
                                                                                                                                  .
                                                                                                                                  .
                                                                                                                                  .
                                                                                                                                  .
                                                                                                                                  .
                                                                                                                                  .
                                                                                                                                  #
#                                                                                                                                ##
##                                                                                                                             #  #
#                                                                                                                               ###
##                                                       #                                                                       ##
##                  #      #   #         #                # #     #                               #            #              # ###
##               #   ##  ##    #  #    ##   #          #   ## #  ##     # #          #         # ##   #  #  # #                ####
# ##   #          ## ######    ### ##  #####           #  #####  ####    ##    # #   # #        ####   ##    ##  #     # #    # ###
##### #       #    ##########   ############         #  ##############  ####    ##    #   #    ########## #  ####       ##  # #####
######### ##   ####################################  ########################  ####  ###   ## ############  #########  ############
###################################################################################################################################