###################################################################################8#  #8###########
#######..### . #      #. ######## .#    #####               .###########  .## #####z    x###########
 ##    #                   ####      .          .                     .             .         .#####
#  #     _                      .                     .                    .             .      ####
#             -                        .       .           -                       .     -        ..
.     -     .   . .  --      .  -   . .   .   -    _    .  .   .      -    _  .  -     .    __     .
.  .   ..   .  _-    .  .. ... . ...--. ... -- _ . .. -_. -. ... .  .   - _                 .      .
... .. -__ . ... .... -.--._... -_. .... .. -._. ... -. _ . --  _ . . _     .   -   .   _          .
..--- .. .   .. ..   ..---- .... . . ..--... ... -- - .... - _  _   ..   -     ..  .   -           .
  . .... --...  __- .... ... -- - ..... ..__ . - -.._  .   _ .   .. .                  .      -    .
..    .     ..     .   .  .     .     .  . .. -- _ .   ... - -    _   _  .    -    .  -     .      .
#         .            -              __ .                   .  --   .         -      __           .
#                           .            .                            -   --    _  .-  _   .       -
##  #         _                                      .           .             .              _   ..
 ###    #                                                                           -             ##
..  . .#### ### #--       ..      #                                                        -      ##
###############.#####..###### ###### .####          ################    .#### #    ########### #####
####################################################################################################