766666666666666666666669
8                      8
8                      8
8                      8
8                      8
8                      8
1666666666dd666666666663