***************************************
******************^^^^^****************
**********^**^^^^^#####^^^^^^**********
*********^#^^################^*********
*********^^####           # ##^********
*******^^## #               ###^^******
******^####                  # ##^*****
*****^^^#                     ##^^*****
****^###                       ###^****
****^###            .           ##^****
*****^# #                      ##^*****
******^###                    ##^#^****
*****^#^^## #                ###^^*****
*********^####             ###^^*******
**********^^^##           #^^^*********
***********^#^^#         #^************
*********^^^^^#         ###^***********
********^#######         #^************
*********^^^^^^#         #^^^^^^^******
*************^#         #########^*****
**********^^^^^#          #^^^^^^******
*********^######         ##^***********
**********^^^^^^#        #^************
***************^##      #^^^^^*********
****************^^#    #######^********
*****************^##   ##^^^^^*********
*****************^#    #^**************
*****************^##  ##^**************
******************^#  #^***************
******************^#  #^***************
*******^^^^^^^^^^^^#  #^***************
******^#############  #^***************
*******^^^^^^^^^^^^#  #^***************
******************^#  #^***************
******************^#  #^***************
******************^#  #^^^^^^^^^*******
******************^#  #########^*******
******************^#  #^^^^^^^^********
******************^#  #^***************
******************^#  #^***************
******************^#  #^***************
*****^^^^^^^^^^^^^^#  #^***************
****^###############  #^***************
*****^^^^^^^^^^^^^^#  #^***************
******************^#  #^***************
******************^#  #^***************
******************^#  #^^^^^^^^^^^^^***
******************^#  ##############^**
******************^#  #^^^^^^^^^^^^^***
******************^#  #^***************
******************^#  #^***************
******************^#  #^***************
*****************^##  ##^**************
****************^##    ##^*************
****************^#8    8#^*************