7666666666666666666666666666666666666666666669
8                                            8
8                                            8
8                                            8
8                                            8
8                                            8
e66666666666666666666666666666666            8
8                                            8
8                                            8
8                                            8
8                                            8
8                                            8
8            66666666666666666666666666666666w
8                                            8
8                                            8
8                                            8
8                                            8
8                                            8
e66666666666666666        6666666666666666666w
8                                            8
8                                            8
8          #  #####     ######               8
8           ###            # ##              8
8         ## #               ###             8
8       ####                  # ##           8
8        #                     ##            8
8     ###                       ###          8
8     ###            .           ##          8
8      # #                      ##           8
8       ###                    ## #          8
8      #  ## #                ###            8
8          #### ##        #####              8
8             ############ #                 8
8            #       #                       8
8                                            8
8                                            8
1666666666666666666666666666666666666666666663