76666666666666666666669
8                     8
8                     8
8                     8
8                     8
8                     8
8                     8
8                     8
8                     8
8                     8
8                     8
8                     8
8                     8
8                     8
8                     8
8                     8
8                     8
8                     8
16666666666666666666663