#######
#     #
#     #
#  .  #
#     #
#     #
#######